█████████████████████████████
█           █               █
█  $        █               
█           ████████        █
█       █                   █
█       █           B       █
█   H   █                   █
█████████████████████████████